0,0,0,0,0,0,0,0
0,1,1,1,1,1,1,0
0,1,1,2,2,1,1,0
0,1,1,3,2,1,1,0
0,1,4,3,2,3,1,0
0,1,5,2,3,3,1,0
0,1,1,1,1,1,1,0
0,0,0,0,0,0,0,0
