0,0,0,0,0,0,0,0,0
0,1,1,1,1,1,1,1,0
0,1,2,21,2,3,18,1,0
0,1,2,2,2,1,5,1,0
0,1,1,2,3,4,21,1,0
0,1,3,2,3,20,21,1,0
0,1,1,2,3,21,21,1,0
0,1,2,2,2,3,3,1,0
0,1,2,2,2,3,21,1,0
0,1,2,2,1,15,15,1,0
0,1,1,1,1,1,1,1,0
0,0,0,0,0,0,0,0,0
