0,0,0,0,0,0,0
0,1,1,1,1,1,0
0,1,3,1,2,1,0
0,1,3,2,3,1,0
0,1,3,2,3,1,0
0,1,3,2,3,1,0
0,1,2,3,2,1,0
0,1,5,1,4,1,0
0,1,1,1,1,1,0
0,0,0,0,0,0,0
