0,0,0,0,0,0,0,0
0,1,1,1,1,1,1,0
0,1,3,11,3,3,1,0
0,1,5,2,2,1,1,0
0,1,2,2,2,1,1,0
0,1,2,2,2,4,1,0
0,1,1,1,1,1,1,0
0,0,0,0,0,0,0,0
