0,0,0,0,0,0,0,0,0
0,1,1,1,1,1,1,1,0
0,1,2,3,2,3,4,1,0
0,1,2,2,3,2,1,1,0
0,1,3,3,2,3,5,1,0
0,1,1,1,1,1,1,1,0
0,0,0,0,0,0,0,0,0
