0,0,0,0,0,0,0
0,1,1,1,1,1,0
0,1,3,3,3,1,0
0,1,2,3,20,1,0
0,1,3,3,3,1,0
0,1,3,1,20,1,0
0,1,5,4,20,1,0
0,1,1,1,1,1,0
0,0,0,0,0,0,0
