0,0,0,0,0,0,0
0,1,1,1,1,1,0
0,1,5,1,4,1,0
0,1,21,1,20,1,0
0,1,3,3,2,1,0
0,1,3,3,2,1,0
0,1,2,1,21,1,0
0,1,21,21,21,1,0
0,1,1,1,1,1,0
0,0,0,0,0,0,0
