0,0,0,0,0,0,0,0
0,1,1,1,1,1,1,0
0,1,3,4,1,1,1,0
0,1,3,2,2,2,1,0
0,1,3,3,5,18,1,0
0,1,3,1,1,2,1,0
0,1,12,1,1,2,1,0
0,1,3,3,3,2,1,0
0,1,1,1,1,1,1,0
0,0,0,0,0,0,0,0
