0,0,0,0,0,0,0,0,0,0,0
0,1,1,1,1,1,1,1,1,1,0
0,1,1,1,11,1,11,5,4,1,0
0,1,1,1,2,1,2,2,3,1,0
0,1,1,1,2,3,2,2,1,1,0
0,1,2,3,2,2,3,1,1,1,0
0,1,1,2,2,2,1,1,1,1,0
0,1,1,1,2,10,1,1,1,1,0
0,1,1,1,1,1,1,1,1,1,0
0,0,0,0,0,0,0,0,0,0,0
