0,0,0,0,0,0,0,0,0
0,1,1,1,1,1,1,1,0
0,1,1,1,5,4,1,1,0
0,1,1,1,3,2,1,1,0
0,1,1,1,3,2,1,1,0
0,1,1,1,2,3,1,1,0
0,1,1,2,3,3,1,1,0
0,1,2,3,3,2,1,1,0
0,1,2,3,2,1,1,1,0
0,1,1,1,1,1,1,1,0
0,0,0,0,0,0,0,0,0
