0,0,0,0,0,0,0,0,0,0
0,1,1,1,1,1,1,1,1,0
0,1,2,1,1,1,1,1,1,0
0,1,3,2,3,2,1,1,1,0
0,1,2,4,3,1,1,1,1,0
0,1,2,1,2,2,3,3,1,0
0,1,2,1,5,1,1,3,1,0
0,1,2,1,1,1,1,3,1,0
0,1,2,1,1,1,1,3,1,0
0,1,2,3,3,3,3,3,1,0
0,1,1,1,1,1,1,1,1,0
0,0,0,0,0,0,0,0,0,0
