0,0,0,0,0,0,0,0
0,1,1,1,1,1,1,0
0,1,3,2,3,21,1,0
0,1,20,2,2,3,1,0
0,1,20,3,2,20,1,0
0,1,20,20,2,20,1,0
0,1,4,1,5,20,1,0
0,1,1,1,1,1,1,0
0,0,0,0,0,0,0,0
